302121013
101221130
201122320
231110303
212220113